111111111111111
1E0C0000C0000C1
100000C0000P001
100001111110001
1000000C000M001
1000C0000C000C1
100000M00000001
111111111111111
