111111111111111
1E0C000MC0000P1
111111111111111