111111111111111
1E0C000MC000MP1
111111111111111