111111111111111
1EPCCCMCCCCMCC1
111111111111111