111111111111111
1EPCCCCCCCCMCC1
111111111111111