111111111111111
1ECCCCCCMCCCCP1
111111111111111