111111111111111
1ECCCMCCMCCCCP1
111111111111111