111111111111111
1ECCCCCCCCCCCC1
1CCCCCCCCCCCCC1
1CCCCMCCCCCCCC1
1CCCCCCCCMCCCC1
1CCCCCCCCCCCCC1
1CCCCCCCCCCCCP1
111111111111111