111111111111111111111111111111
111111111111111111111111111111
1111111M1111111111111111111111
11111111111111C111111111111111
1111111111111PCE11111111111111
11111111111111C111111111111111
111111111111111111111111111111
111111111111111111111111111111