111111
1CE001
100111
100011
1P0011
111111