111111111111111111111111111111111111111111111111111111111111
1C00000000000000000010000000C000001000100000000C100000000001
11111110000000000000000100000001000001000100001110000000C001
10000000000C100000001111111111111111111111110000000010000001
100111110000110000000001C00000000000000C100C0000000000000001
10000000100000C00000100C001000011C0011111111111000000000C001
100000001000000000001001001000001010000000000000001110000001
1000000C100000C1111111111111111010100000011110100000100C0001
1001111111111111000000C1000000001010010010C00010000010000001
10000001E00000000010000100000000000000000011C110000010000C01
1C0010000001PC1000011111000000111010010000000000000011111111
11111111111111111000000000000001C000000000000111111000000001
10C00000110000000000000100000001010000011111110000000011C001
1000000C001000C000011111111100010001000000000100111100110001
10001110111000000001C100000000000001000000000100000000000001
1011101110111111111101010011111111011111111111000010000C0001
100000000000000000010100001000000000000000000100000100000001
101110111011111111110000001000C001000001010001C0001000011101
1000111C111C010000011111111000000100C001C100000000000001C001
10000000101001C010000000000000000000000111000000010100000001
100001001010011100001000001111111111111111111110010100111111
11111100001000110110100C00000010000C0010000000000101000000C1
100000000C10000000001000000100100001011010000011110001111111
101110111010011111111111111100000001000010000010000C00000001
100011101110000000000000100001000001111011111110111111111101
100001000000001000001C00100101000001000000000000000010000101
100C0101110000000C00110000010100000100100C10000C000010000101
10000101C1100001000001011111111110110111111111100001C0000101
1C0000010000000000000100000C000000010C00000000000000000001C1
111111111111111111111111111111111111111111111111111111111111