1111111111111111111111111111
1C000000010000C1000001E00001
1001100101000100000011100001
1000101C000010000011100000C1
1P00100000000C1000C000010001
1111111111111111111111111111