1111111
1111111
10000P1
1CCCCC1
1E00001
1111111
1111111
