111111111111111111111111111111111111111111111111111111111111
100100000000001111011110CCC001CC011010100C0C0100C01010000001
1C01011000110000010001000C11CC00000010C0C001000100C100100001
1100CC0CCC0000000010CC00000100000C1000C010010C10000C00110001
10C00000001000010000C00000C000000100010000000100000C00000001
110001000000100011100100110000100C10100010001010100100C00001
1010CC10C0000110010001101011101001CC000010C10000100000000011
10010010C000000010001000110C0000000C1C000000001C11000101C101
10100010CC000000001000001C1001C101C00C011011000C00C000000P01
1000001000000000C1CC100C000100011000011C00010C100C00000000C1
10110101E000C010C0010000C000C00000CC0000000100C10000C0000001
100000010010C00C00C10010000000C0000000C001C000C00101C0C01011
100100C000000000010001C10110000001000C0001100110C000000C0011
11000CC0011000000000101000100000000C001010C010000000C0011011
11010000011000100C10C010C00000000000000100000010010C0011C101
100000C100111110000110000011C000100000000100100100C110011101
100100000000010110000010111000C001001101100100110100C0011011
11000C00001C0000100C001001001001000C0000C1000100100100000001
111000C100000000100000C010C000000000C011C000C001001000000001
1C0000010000001010000110010000C0100000C100001100000000CC0011
100000000C00CC0C0CCC00000C0000C00C11000110101000000000111001
1C010C011110000C00010000001C00001C100000C1111001000000101001
100010000000001C000C0001001C00000010000010101000100000C11101
110000000000000000010000000000001000000110000011000100000011
1000CC000000C1C10001000C0100100C00000C1C0C001000000C00CC0111
1C0C00000001000000000000010C0C001110110100C011C01010000C0001
10C001C001011C0100C00000100C001C0C100101C00C1011001011001101
11000000000000000001000110010C01100100100C01011000000CC01001
100000001000110000000000000100C011010011C0C1010001110C110001
111111111111111111111111111111111111111111111111111111111111