111111111111111111111111111111111111111111111111111111111111
11C000C01000010C00C1111001000000100001000001010000010C00C001
10000100000100C0000100000001C010000000000C00000000P010C00001
101100000100C110000000001001001C001100000C1000C0000C00001101
1C0C00C1C0000C10100C0011010001000000111011000010C000000C1111
101000C0C0010000001C00000101010C0100C000001000C10000C1000001
10110000C001000CC0110010001010001C00010000000C000000010C0001
1000000100000001011010100000000100CC000010000010011100000011
1000C0011001000C00000100C10C0C10001000000CC000000000010CC101
1000000C1C0C00100001000C0010011010C0000000C00C00000010100001
100000000010010000000100010000CC01000010C100101010010000C011
11C000100001101010001110000000000C0CC00C01001C01011C00001001
10000000C0C000100001C10000001C0000010001111000000010100001C1
101C1C00110101010010C110C00010000010011000100C00001100000C01
10000000000C000000100C1000CC00C00100000000C000CC0C0000100101
1000C1C10001001000100000110000000000010010C00100100000000111
1000101000C000CC00C000000001011100000C0000000001000001100C01
100C1000000100000C00000001010010CC0C01100001C000000000100101
1000000010010C100000001C0100C11001C000000100001C000000001001
100010001001CC00111001011001000001000010000C0010000C01000001
100C00100000C00C110C000000C001000011000010C0000000000000C001
101000011000011000110011C000C01C0C011000000000C111000C000001
1010000010011001001011000000C10C00C1000000011001000011000001
1100010010010000010000C0100C001C0C000001110000100100111C0001
1C00C00000C010000C010000001E000000000100001000000100C1010001
11C00000000101000011011C0C000C0001C000100000C0000CC0001100C1
10110010001000100C0C000000C0000000100101C0000000000100100001
1C001000010C01C000000000C00101C00000C010001011C1001001CC1011
10001C0000001010111001100100000000100C010000C010010100000101
1001010010C000100001C01C001001000C0000111CC0C0C000C10000C011
10000000110100100CC000101110010000110100100000110C0000C00011
111111111111111111111111111111111111111111111111111111111111