1111111111111111111111111111
1000000001000001000001E00001
1001100101000100000011100001
1000101000001000001110000001
1P00100000000010000000010001
1111111111011111111111111111